21111211113
10000100002
10000100002
10000100002
21111311113